  # # # # # # # # #   # # # # #   # # # # # # # # # # # # #   # # # # # # #   #  
# . . . . . . . . . # . . . . . # . . . . . . . . . . . . . # . . . . . . . # . #
# . # # # . # # # . # . # # # . # . # # # # # # # # # # # . # . # # # # # . # . #
# . . . # . . . # . . . # . # . # . . . # . . . # . . . . . # . # . . . # . # . #
  # # . # # # . # # # # # . # . # # # . # . # . # . # # # # # . # . # # # . # . #
# . # . # . # . . . . . # . # . . . # . . . # . # . . . # . . . # . . . . . . . #
# . # . # . # # # # # . # . # # # . # # # # # . # # # . # . # . # # # # # # # . #
# . # . . . . . # . # . # . . . . . # . # . . . # . # . # . # . . . . . . . # . #
# . # # # # # . # . # . # . # # # # # . # . # # # . # . # # # # # # # . # . # . #
# . . . # . . . # . # . # . . . # . . . # . # . . . # . # . . . . . # . # . # . #
# . # . # . # # # . # . # # # . # # # . # . # # # . # . # . # # # . # # # . # #  
# . # . # . . . # . # . . . # . . . . . # . # . . . # . # . . . # . . . # . . . #
# . # # # # # . # . # # # . # # # # # . # . # . # # # . # . # . # # # . # # # . #
# . . . . . # . # . . . # . # . . . . . # . # . . . . . # . # . . . # . . . # . #
  # # . # # # . # . # # # . # # # . # # # . # . # # # # # # # # # . # # # . # . #
# . . . # . . . # . . . # . . . # . . . # . # . # . . . . . . . # . # . # . # . #
# . # # # . # # # # # . # # # . # # # . # . # . # . # . # # # . # . # . # . # . #
# . . . . . # . . . . . . . # . # . . . # . # . # . # . . . # . # . # . . . # . #
# . # # # # # . # . # . # # # . # . # # # . # . # . # # # . # . # . # . # # # . #
# . . . . . # . # . # . # . . . # . # . . . # . # . . . # . # . # . # . # . . . #
  # # # # . # # # . # # # . # # # . # . # # # . # # # # # . # . # . # . # . # . #
# . . . # . . . . . # . . . # . # . # . . . # . # . . . # . # . . . # . . . # . #
  # # . # # # # # . # . # # # . # . # # # # # . # . # . # . # # # # # # # # # . #
# . . . . . # . . . # . . . # . . . # . . . # . # . # . . . # . . . . . # . . . #
# . # # # # # . # #   # # . # # # # # . # . # . # . # # # # # . # # # . # # # . #
# . . . . . . . . . # . . . # . . . . . # . . . # . # . . . . . # . # . . . # . #
# . # # # # # # # # # . # . # . # # # #   # # # # . # . # # # # # . # # # . # #  
# . # . . . # . . . . . # . # . # . . . # . . . . . # . # . . . . . . . # . . . #
# . # . # # # . # # # . # # # . # . # # # . # . # # # . # . # # # . # # # # # . #
# . # . # . . . # . . . # . . . # . . . . . # . . . . . # . # . . . # . . . . . #
# . # . # . # # # . # # # . # # # . # # # # # # # # # . # . # # # # # . # # # #  
# . # . # . . . # . # . # . . . # . . . # . . . . . # . . . # . . . # . . . . . #
# . # . # # # . # . # . # # # . # # # . # . # # # . # . # # # . # . # # # # # . #
# . . . . . # . # . # . . . # . . . # . # . # . # . # . # . . . # . . . # . . . #
  # # . # # # . # . # # # . # # # . # # # . # . # . # # # . # # # # # . # . # . #
# S # . # . . . # . . . . . . . # . . . . . # . # . . . . . # . . . # . . . # . #
# . # . # . # # # # # # # # # # # # # # # # # . # # # # # # # . # # # # # # # . #
# . # . # . . . . . . . . . . . . . # . . . # . . . . . # . . . # . . . . . # . #
# . # . # # # # # # # # # # # # # . # . # . # . # # # . # . # . # . # # # . # . #
# . . . . . . . . . . . . . . . # . . . # . . . . . # . . . # . . . . . # . . . #
  # # # # # # # # # # # # # # #   # # #   # # # # #   # # #   # # # # #   # # #  